1    1    1    1    1    1    1    1    1    1    1    1    1    1                      1                  1 1 1      2 2 2 2 2 2 2 2 2 2 2 2
                                                                    1                 1   1              1    1       2 2 2 2 2 2 2 2 2 2 2 2
                                                                      1             1       1          1              2 2 2 2 2 2 2 2 2 2 2 2
                                                                        1        1            1      1                2 2 2 2 2 2 2 2 2 2 2 2                                                                                                                     2 2 2 2
                                              5                            1   1                1  1                  2 2 2 2 2 2 2 2 2 2 2 2
                                                                             1                   1                    2 2 2 2 2 2 2 2 2 2 2 2
4              d                                                                                                      2 2 2 2 2 2 2 2 2 2 2 2
              d                                                                                 3                     2 2 2 2 2 2 2 2 2 2 2 2
             d              3                             3                                               3           2 2 2 2 2 2 2 2 2 2 2 2
            d                                         0                                                               2 2 2 2 2 2 2 2 2 2 2 2
                  0      000                      0                          0 0                                      2 2 2 2 2 2 2 2 2 2 2 2
                0       0     00  00                                       0  0      3                0               2 2 2 2 2 2 2 2 2 2 2 2                 
        0     0                  0     00  00 0          0        0       0 22222222      00 000   0        0    0    2 2 2 2 2 2 2 2 2 2 2 2                    
00000      00   0 02222            00                22 2 200000  222222  2222222222222222  2222222222222222222222222222 2 2 2 2 2 2 2 2 2 2 
222222222222222222222222222222222222222222222222222222222222222222222222222222222222222222222222222222222222222222222222222222222222222222222e
                                        