1    1    1    1    1    1    1    1    1    1    1    1    1    1                                                    2 2 2 2 2 2 2 2 2 2 2 2
                                                                                                                      2 2 2 2 2 2 2 2 2 2 2 2
                                                                                                             5        2 2 2 2 2 2 2 2 2 2 2 2
                                                                                                                      2 2 2 2 2 2 2 2 2 2 2 2                                                                                                                     2 2 2 2
                                                                                                                    3 2 2 2 2 2 2 2 2 2 2 2 2
                                                                                                                   3  2 2 2 2 2 2 2 2 2 2 2 2
                                                                                                                  3   2 2 2 2 2 2 2 2 2 2 2 2
dddd                                                                                                             3    2 2 2 2 2 2 2 2 2 2 2 2
                           3                             3                                                      3     2 2 2 2 2 2 2 2 2 2 2 2
                                                     0                                                         3      2 2 2 2 2 2 2 2 2 2 2 2
4                 0      000                      0                          0 0                               3      2 2 2 2 2 2 2 2 2 2 2 2
                0       0     00  00                                       0  0      3                                2 2 2 2 2 2 2 2 2 2 2 2                 
             0                  0     00  00 0          0        0       0   0           00 000                       2 2 2 2 2 2 2 2 2 2 2 2                    
00000    0 00    0 0                00        222222        0000000    0  0    0    00  0            0  0  0   0   0  2 2 2 2 2 2 2 2 2 2 2 2
222222222222222222222222222222222222222222222222222222222222222222222222222222222222222222222222222222222222222222222222222222222222222222222e
                                        