1    1    1    1    1    1    1    1    1    1    1    1    1    1    1    1    1    1    1    1    1    1    1       2 2 2 2 2 2 2 2 2 2 2 2
                                                                                                                      2 2 2 2 2 2 2 2 2 2 2 2
                                                                                                  1                   2 2 2 2 2 2 2 2 2 2 2 2
                                                         1    5               3                                       2 2 2 2 2 2 2 2 2 2 2 2
                                                                                                                      2 2 2 2 2 2 2 2 2 2 2 2
                                      3                                 3                                             2 2 2 2 2 2 2 2 2 2 2 2
                                                                                                                      2 2 2 2 2 2 2 2 2 2 2 2
dddd                                         3                                                  3                     2 2 2 2 2 2 2 2 2 2 2 2
                           3                             3                            3                   3           2 2 2 2 2 2 2 2 2 2 2 2
                                                                                                                      2 2 2 2 2 2 2 2 2 2 2 2
4                         000                    0               0    0    0    0    0                                2 2 2 2 2 2 2 2 2 2 2 2
00000       0    0       0     00    0                    0        222                                0               2 2 2 2 2 2 2 2 2 2 2 2                 
        0          0 0             0     00  00 0                    222         2222222      00   000   0        0   2 2 2 2 2 2 2 2 2 2 2 2                    
     222     00 22              00               2222222 0000  222222  2222222222222222 2222222222222222222222222222  2 2 2 2 2 2 2 2 2 2 2 2
222222222222222222222222222222222222222222222222222222222222222222222222222222222222222222222222222222222222222222222222222222222222222222222
                                        