1    1    1    1    1    1    1    1    1    1    1    1    1    1                                                    2 2 2 2 2 2 2 2 2 2 2 2
                                                                                                                      2 2 2 2 2 2 2 2 2 2 2 2
                                                                                                                      2 2 2 2 2 2 2 2 2 2 2 2
                                        3                                                                             2 2 2 2 2 2 2 2 2 2 2 2                                                                                                                     2 2 2 2
                                      3                                                                               2 2 2 2 2 2 2 2 2 2 2 2
                                                                                                                      2 2 2 2 2 2 2 2 2 2 2 2
                                                  0                                                                   2 2 2 2 2 2 2 2 2 2 2 2
dddd                                                0                                                                 2 2 2 2 2 2 2 2 2 2 2 2
                           3                     0                                                                    2 2 2 2 2 2 2 2 2 2 2 2
                                                     0                                                                2 2 2 2 2 2 2 2 2 2 2 2
              00     00                         0                                                          3          2 2 2 2 2 2 2 2 2 2 2 2
             0         0        00  00                 0                                                              2 2 2 2 2 2 2 2 2 2 2 2
        0   0           0      0      0        0                                                                      2 2 2 2 2 2 2 2 2 2 2 2
00000    000    00000    000000        00000000          0000         0                 000000000000000000            2 2 2 2 2 2 2 2 2 2 2 2
2 2 2 2 2 2 2 2 2 2 2 2 2 2 2 2 2 2 2 2 2 2 2 2 2 2 2 2 2 2 2 2 2 2 2 2 2 2 2 2 2 2 2 2 2 2 2 2 2 2 2 2 2 2 2 2 2 2 2 2 2 2 2 2 2 2 2 2 2 2 2